# Common Japanese Words Kanji Dictionary for RomajiSwitcher
# Format: romaji=kanji
# Inspired by LunaChat's Japanizer

# Greetings
arigatou=有難う
arigatougozaimasu=ありがとうございます
arigatai=有難い
onegai=お願い
onegaishimasu=お願いします
domo=どうも
oyasuminasai=お休みなさい
oyasumi=お休み
ohayougozaimasu=おはようございます
ohayou=おはよう
konnichiwa=こんにちは
konbanwa=こんばんは

# Adjectives
sugoi=凄い
sugee=凄え
mazui=不味い
oishii=美味しい
kawaii=可愛い
atarashii=新しい
furui=古い
okii=大きい
tiisai=小さい
chiisai=小さい
hayai=速い
osoi=遅い
tsuyoi=強い
yowai=弱い
takai=高い
hikui=低い
fukai=深い
asai=浅い
wakai=若い
atsui=厚い
usui=薄い
karui=軽い
omoi=重い
nagai=長い
mijikai=短い
akai=赤い
aoi=青い
shiroi=白い
kuroi=黒い

# Places
tokyo=東京
osaka=大阪
kyoto=京都

# Common Verbs
taberu=食べる
tabeta=食べた
nomu=飲む
nonda=飲んだ
iku=行く
itta=行った
kuru=来る
kita=来た
suru=する
shita=した
dekiru=出来る
dekita=出来た
wakarou=分かろう
wakatta=分かった
kiku=聞く
kiita=聞いた
yomu=読む
yonda=読んだ
kaku=書く
kaita=書いた
hanasu=話す
hanashita=話した
kite=来て
itte=行って
kaette=帰って
akete=開けて
shimete=閉めて
matte=待って
yonde=読んで
kaite=書いて
hanashite=話して
kiite=聞いて

# Family
otousan=お父さん
okaasan=お母さん
ani=兄
oniisan=お兄さん
imouto=妹
imoutosan=妹さん
oji=叔父
ojii=叔父さん
oba=叔母
obasan=叔母さん

# School
gakkou=学校
sensei=先生
gakusei=学生
daigaku=大学
shukudai=宿題
kyoukasho=教科書
sakubun=作文

# Nouns
otoko=男
onna=女
shounen=少年
shoujo=少女
seito=生徒
kodomo=子ども
kodomotachi=子どもたち
tori=鳥
inu=犬
neko=猫
sakana=魚
mi=水
hi=日
tsuki=月
hoshi=星
kumo=雲
ame=雨
kaze=風
yuki=雪

# Subjects
kokugo=国語
sansu=算数
rika=理科
shakaika=社会科
taiiku=体育
ongaku=音楽
bijutsu=美術
kougei=工芸
katei=家庭

# Work/Office
kacho=課長
bucho=部長
shacho=社長
shachou=社長

# Other common words
osusume=お勧め
rikai=理解
seishin=精神
seikatsu=生活
seikaku=性格
